       NO textures/Brick_02-256x256.png
SO textures/Metal_15-256x256.png
WE textures/Tile_08-256x256.png
EA textures/Wood_07-256x256.png

F 20,20,190
C 64,64,64

     111111111111111111111111111111111
110000000011000001110111111111111
11110111111111011100000010001
11110111111111011101010010001
11000000110101011100000010001
10000000000000001100000010001
10000000000000001101010010001
11000001110101011111011110N0111
11110111 1110101 101111010001
11111111 1111111 111111111111