       NO textures/Brick_02-256x256.png
WE textures/Tile_08-256x256.png
SO textures/Metal_15-256x256.png
EA textures/Wood_07-256x256.png

F 20,20,190
C 64,64,64

11111
10N01
11111



