NO textures/checker-map_tho.png
SO textures/Metal_15-256x256.png
WE textures/Tile_08-256x256.png
EA textures/Wood_07-256x256.png

F 20,20,190
C 40,133,84

        1111111111111111111111111111111111111111111111111111111111111111111111111111111111111111111111111111111
        1000000000110000000000000000000000000000000000000000000000000000000000000000000000000000000000000000001
        10110000011100000000000000000W0000000000000000000000000000000000000000000000000000000000000000000000001
        1001000000000000000000000000000000000000000000000000000000000000000000000000000000000000000000000000001
111111111011000001110000000000000000000000000000000000000000000000000000000000000000000000000000000000000000001
100000000011000001110000000000000000000000000111111111111111111111111111111111111111111111111111111111111111111111111111111111111111111111111
11110111111111011100000000000000000000000000000010001
111111111111110111111111111111111111111111111111111111111111111111111111111111111111111111111111111111111111111
        1000000000110000000000000000000000000000000000000000000000000000000000000000000000000000000000000000001
        1011000001110000000000000000000000000000000000000000000000000000000000000000000000000000000000000000001
        1001000000000000000000000000000000000000000000000000000000000000000000000000000000000000000000000000001
111111111011000001110000000000000000000000000000000000000000000000000000000000000000000000000000000000000000001
100000000011000001110000000000000000000000000111111111111111111111111111111111111111111111111111111111111111111111111111111111111111111111111
11110111111111011100000000000000000000000000000010001
111111111111110111111111111111111111111111111111111111111111111111111111111111111111111111111111111111111111111
        1000000000110000000000000000000000000000000000000000000000000000000000000000000000000000000000000000001
        1011000001110000000000000000000000000000000000000000000000000000000000000000000000000000000000000000001
        1001000000000000000000000000000000000000000000000000000000000000000000000000000000000000000000000000001
111111111011000001110000000000000000000000000000000000000000000000000000000000000000000000000000000000000000001
100000000011000001110000000000000000000000000111111111111111111111111111111111111111111111111111111111111111111111111111111111111111111111111
11110111111111011100000000000000000000000000000010001
11110111111111011101000000000000000000000000010010001
11000000110101011100000000000000000000000000000010001
10000000000000001100000000000000000000000000000010001
10000000000000001101000000000000000000000000010010001
1100000111010101111100000000000000000000000001111000111
11110111 1110101 1011110100011111111111111111111111111111
11111111 1111111 111111111111