NO textures/Brick_02-256x256.png
SO textures/Metal_15-256x256.png
WE textures/Tile_08-256x256.png
EA textures/Wood_07-256x256.png

F 20,20,190
C 40,133,84

        111111111111111111111111111111111111111111111111111111111111111111111111111111111111111111111111111111111
        1000000000110000000000000000000000000000000000000000000000000000000000000000000000000000000000000000001
        1011000001110000000000000000000000000000000000000000000000000000000000000000000000000000000000000000001
        1001000000000000000000000000000000000000000000000000000000000000000000000000000000000000000000000000001
111111111011000001110000000000000000000000000000000000000000000000000000000000000000000000000000000000000000001
100000000011000001110000000000000000000000000111111111111111111111111111111111111111111111111111111111111111111111111
11110111111111011100000000000000000000000000000000001
11110111111111011101000000000000000000000000010000001
110000001101010111000000000000000000000000000000100011
100000000000000011000000000000000sdddda000000000000000100011111111111111111111111111111111111111111111111111111
100000000000W00011010000000000000000000000000100100000000000000000000000000000000000000000000000000000001
110000011101010111110000000000000000000000000111100000000000000000000000000000000000000000000000000000001
11110111 1110101 1011110100011111111111111111111111111111111111111111111111111111111111111111111111111111
11111111 1111111 111111111111
11111111 1111111 111111111111